11111111111111111111
1000000000000000C001
100000000000000E0001
10001000000CP0000001
11111111111111111111