111111111111111111111111111
100E00000010000000000000001
100000000010000000000000001
100C000000100000C0000P00001
100000000000000000000000001
111111111111111111111111111